############################################################
############################################################
############################################################
############################################################
############################################################
#####__________________________________________________#####
#####_################################################_#___#
#####_################################################_|___#
#####_################################################_#___#
#####_################################################_#####
#####_################################################_#####
#####_################################################_#####
#####_################################################_#####
#####_################################################_#####
#####_################################################_#####
#####_################################################_#####
#####_################################################_#####
#####_################################################_#####
#####_################################################_#####
#####_################################################_#####
#####_################################################_#####
#####_################################################_#####
#####_################################################_#####
#####_################################################_#####
#####_################################################_#####
#####_################################################_#####
#####_################################################_#####
#####_################################################_#####
#####_################################################_#####
#####_################################################_#####
#####_################################################_#####
#####_################################################_#####
#####_################################################_#####
#####_################################################_#####
#####_################################################_#####
#####__________________________________________________#####
############################################################
############################################################
############################################################
############################################################
############################################################